*E*******
*       *
*       *
T
*       *
*   S   *
*       *
*       *
*********