*E*******
*       *
******* *
T       *
* *******
*       *
******* *
*S      *
*********