*E*******
*       *
******* *
*       *
* *******
*       *
******* *
*S      *
*********