*********
* *    E*
*  *    *
*   *   *
*    *  *
*     * *
*      **
*S      *
*********