****E****
* **  * *
**    ***
**     **
**   * **
* * **  *
** * ****
* *     *
S********