******E**
* * *  **
** *    *
*  ** * *
* **    *
*   *T  *
*  ** ***
*   *   *
S********