******E**
* * *  **
** *    *
*  ** * *
* **    *
*   **  *
*  ** ***
*   *   *
S********